I	من
Do	انجام دادن
Go	برو
He	او
Me	من
My	من
No	نه
On	بر
Or	یا
So	بنابراین
Up	بالا
We	ما

Read also:  Learn Fruits names in Persian
Easy words
3 letter words
Act	عمل کنید
Add	اضافه کردن
Age	سن
Aim	هدف
Air	هوا
All	همه
And	و
Ant	مورچه
Any	هر
Ask	پرسیدن
Bad	بد
Big	بزرگ
Buy	خرید
Cry	گریه کردن
Dam	سد
Die	بمیر
Dry	خشک
End	پایان
Ear	گوش
Eat	خوردن
Egg	تخم مرغ
Eye	چشم
Fat	چربی
Fly	پرواز
Fun	سرگرم کننده
Get	گرفتن
God	خداوند
Hen	مرغ
Hot	داغ
Job	کار
Leg	پا
Lie	دروغ
Low	کم
Mad	دیوانه
Man	مرد
Not	نه
Now	اکنون
New	جدید
Old	قدیمی
Own	خود
Run	اجرا کن
Sad	غمگین
Sea	دریا
See	دیدن
Shy	خجالتی
Sit	بنشین
Sum	مجموع
Sun	آفتاب
Tax	مالیات
Try	تلاش كردن
Use	استفاده کنید
War	جنگ
Wet	مرطوب
Why	چرا
Win	پیروزی
Yes	آره
You	شما

Read also:  Learn Body parts names in Persian
4 letter words
Also	همچنین
Baby	عزیزم
Back	بازگشت
Bake	پختن
Bald	بدون مو
Ball	توپ
Bark	پارس سگ
Bath	حمام
Beet	چغندر
Bend	خم شدن
Best	بهترین
Bird	پرنده
Bold	پررنگ
Bone	استخوان
Book	کتاب
Born	بدنیا آمدن
Both	هر دو
Busy	مشغول
Call	زنگ زدن
Calm	آرام
Care	اهميت دادن
Come	بیا
Cost	هزینه
Cute	جذاب
Crow	کلاغ
Dare	جرات
Dark	تاریک
Date	تاریخ
Deal	معامله
Diet	رژیم غذایی
Dish	ظرف
Door	در، درب
Down	پایین
Dust	گرد و خاک
Each	هر یک
Earn	بدست آوردن
Easy	آسان
Edge	حاشیه، غیرمتمرکز
Evil	بد
Exit	خروج
Face	صورت
Fact	حقیقت
Fair	نمایشگاه
Fake	جعلی
Farm	مزرعه
Fast	سریع
Fear	ترس
Feel	احساس کنید
Find	پیدا کردن

Read also:  100 Fruits names with pictures in English
Fine	خوب
Fish	ماهی
Food	غذا
Fool	احمق
Free	رایگان
Frog	قورباغه
Full	پر شده
Gape	گیج کردن
Gift	هدیه
Girl	دختر
Goat	بز
Good	خوب
Grab	گرفتن
Grow	رشد
Half	نیم
Hate	نفرت
Head	سر
Hear	شنیدن
Heat	حرارت
Help	کمک
Here	اینجا
Hide	پنهان شدن
High	بالا
Hold	نگه دارید
Hole	سوراخ
Home	خانه
Huge	بزرگ
Hurt	صدمه
Idea	اندیشه
Jump	پرش
Just	فقط
Kill	کشتن
Land	زمین
Last	آخر
Late	دیر
Left	ترک کرد
Life	زندگی
Line	خط
Lion	شیر نر
Long	طولانی
Look	نگاه کن
Lost	گمشده
Love	عشق
Luck	شانس
Lung	ریه
Many	زیاد
Meet	ملاقات
Melt	ذوب شدن
Milk	شیر
Must	باید
Name	نام
Near	نزدیک
Neat	مرتب
Neck	گردن

Read also:  Learn Insurance vocabulary in Persian
Need	نیاز
Next	بعد
Only	فقط
Pain	درد
Pair	جفت
Park	پارک
Path	مسیر
Play	بازی
Poor	فقیر
Pull	کشیدن
Pure	خالص
Quit	ترک کردن
Quiz	مسابقه
Race	نژاد
Rain	باران
Rare	نادر
Real	واقعی
Rent	اجاره
Rest	باقی مانده
Rich	ثروتمند
Ride	سوار شدن
Rise	بالا آمدن
Risk	خطر
Room	اتاق
Rope	طناب
Rude	بی ادب
Sage	حکیم
Sail	سفر دریایی
Salt	نمک
Same	یکسان
Sand	شن
Save	صرفه جویی
Scam	کلاهبرداری
Seed	دانه
Seek	به دنبال
Self	خود
Sell	فروش
Send	ارسال
Shop	فروشگاه
Show	نشان می دهد
Sick	بیمار
Side	سمت
Site	سایت
Size	اندازه
Skin	پوست
Slow	آهسته. تدریجی
Soft	نرم
Soil	خاک
Some	مقداری

Read also:  Learn Family Relationship names in Persian
Soon	به زودی
Stay	اقامت کردن
Stop	متوقف کردن
Such	چنین
Swap	مبادله
Swim	شنا کردن
Take	گرفتن
Talk	صحبت
Tall	بلند قد
Team	تیم
Tell	بگو
Tent	چادر
That	که
Then	سپس
Thin	لاغر
This	این
Tide	جزر و مد
Time	زمان
Tour	تور
Town	شهر
Tree	درخت
Trip	سفر
Turn	دور زدن
Ugly	زشت
Vase	گلدان
Vein	رگ
Very	بسیار
View	چشم انداز
Wage	حق الزحمه
Wait	صبر کن
Wake	از خواب بیدار
Walk	راه رفتن
Wall	دیوار
Want	خواستن
Warm	گرم
Warn	هشدار دهد
Weak	ضعیف
Wear	پوشیدن
Week	هفته
Well	خوب
Went	رفت
What	چی
When	چه زمانی
Wide	وسیع
Wife	همسر
Wild	وحشی
Will	اراده
Wind	باد
Wine	شراب
Wish	آرزو کردن
Wood	چوب
Wool	پشم
Word	کلمه
Work	کار کردن
Worm	کرم
Yarn	نخ
Your	شما
Zoom	بزرگنمایی
5 letter words
About	در باره
Above	در بالا
Adapt	سازگار شدن
Admit	اقرار کردن
Adult	بالغ
After	بعد از
Again	از نو
Agree	موافق
Alert	هشدار
Allow	اجازه
Alone	تنها
Along	در امتداد
Anger	عصبانیت
Angle	زاویه
Angry	خشمگین
Asset	دارایی
Avoid	اجتناب کردن
Awake	بیدار
Aware	آگاه
Begin	شروع
Birth	تولد
Blood	خون
Brain	مغز
Built	ساخته شده
Bring	آوردن
Build	ساختن
Camel	شتر
Canal	کانال
Carry	حمل
Cheap	ارزان
Cheat	تقلب
Check	بررسی
Chest	قفسه سینه
Claim	مطالبه
Clean	تمیز
Clear	روشن
Climb	بالا رفتن
Close	بستن
Cloth	پارچه
Cloud	ابر
Color	رنگ
Crime	جرم
Crowd	جمعیت
Crown	تاج پادشاهی
Daily	روزانه
Dance	رقصیدن
Death	مرگ
Decay	پوسیدگی
Delay	تاخیر انداختن
Devil	شیطان
Dirty	کثیف
Dress	لباس

Read also:  Learn School things names in Persian
Drink	نوشیدنی
Drive	راندن
Dwell	ساکن
Eager	مشتاق
Eagle	عقاب
Early	زود
Earth 	زمین
Elder	بزرگتر
Empty	خالی
Enemy	دشمن
Enjoy	لذت ببرید
Entry	ورود
Equal	برابر
Essay	مقاله
Event	رویداد
Every	هر
Exact	دقیق
Exist	وجود داشته باشد
Extra	اضافی
Faith	ایمان
Fault	عیب
Fever	تب
Field	رشته
Final	نهایی
Fleet	ناوگان
Float	شناور
Flood	سیل
Floor	کف
Flour	ارد
Fluid	مایع
Focus	تمرکز
Force	زور
Fraud	تقلب
Fresh	تازه
Front	جلو
Fruit	میوه
Ghost	روح
Globe	کره زمین
Going	رفتن
Grain	غلات
Grant	اعطا کردن
Grass	چمن
Great	عالی
Group	گروه
Guard	نگهبان
Guest	مهمان
Habit	عادت داشتن
Heart	قلب
Honey	عسل
Horse	اسب
House	خانه
Human	انسان
Ideal	ایده آل
Issue	موضوع
Judge	قضاوت کنید
Knife	چاقو

Read also:  Learn Ology vocabulary words in Persian
Labor	کار یدی
Ladle	ملاقه
Large	بزرگ
Laugh	خنده
Learn	فرا گرفتن
Leave	ترک کردن
Legal	مجاز
Limit	حد
Lunch	ناهار
Metal	فلز
Mixed	مختلط
Money	پول
Month	ماه
Mount	کوه
Mouth	دهان
Music	موسیقی
Maize	ذرت
Naked	برهنه
Never	هرگز
Night	شب
Niece	دختر برادر یا خواهر و غیره
Noise	سر و صدا
Occur	به وقوع پیوستن
Ocean	اقیانوس
Onion	پیاز
Offer	پیشنهاد
Order	سفارش
Organ	عضو
Other	دیگر
Owner	مالک
Paddy	شالیزار
Panic	وحشت
Peace	صلح
Place	محل
Plant	گیاه
Price	قیمت
Pride	غرور
Proud	مغرور
Prove	ثابت كردن
Quilt	لحاف
Quick	سریع
Quite	کاملا
Raise	بالا بردن
Reach	رسیدن
React	واکنش نشان دهند
Ready	آماده
Reply	پاسخ
Right	درست
Round	گرد
Rural	روستایی
Saint	قدیس
Scope	محدوده
Score	نمره
Sense	احساس، مفهوم
Shake	تکان دادن
Shape	شکل
Share	اشتراک گذاری
Sharp	تیز
Shrub	درختچه

Read also:  Learn Travels vocabulary in Persian
Skill	مهارت
Sleep	خواب
Slope	شیب
Small	کم اهمیت
Smell	بو
Smile	لبخند
Snake	مار
Snore	خروپف کردن
Solid	جامد
Sound	صدا
Space	فضا
Speak	صحبت
Speed	سرعت
Spend	خرج کردن
Spent	صرف کرد
Sperm	اسپرم
Sport	ورزش
Stand	ایستادن
Steam	بخار
Stone	سنگ
Story	داستان
Taste	طعم
Teach	آموزش دهید
Teeth	دندان ها
Thank	تشکر
There	آنجا
These	اینها
Thick	ضخیم
Thing	چیز
Tiger	ببر
Today	امروز
Total	جمع
Treat	درمان شود
Trend	روند
Tried	تلاش کرد
Trust	اعتماد
Truth	حقیقت
Twice	دو برابر
Under	زیر
Upper	بالا
Urban	شهری
Visit	بازدید کنید
Voice	صدا
Vomit	استفراغ
Waste	هدر
Water	اب
Wheat	گندم
Where	جایی که
White	سفید
Whole	کل
Woman	زن
World	جهان
Worst	بدترین
Write	نوشتن
Wrong	اشتباه
Yield	بازده
Young	جوان
Youth	جوانان
Medium words
6 letter words
Absent	غایب
Accept	تایید کنید
Admire	تحسین
Advice	مشاوره
Almost	تقریبا
Always	همیشه
Animal	حیوان
Answer	پاسخ
Appeal	درخواست
Appear	به نظر می رسد
Arrive	رسیدن
Artist	هنرمند
Assist	کمک کند
Attack	حمله کنند
Attach	ضمیمه کردن
Attend	مراجعه كردن
Bangle	النگو
Before	قبل از
Behind	پشت
Bellow	زیر
Better	بهتر
Borrow	امانت گرفتن
Bottom	پایین
Broken	شکسته شده
Budget	بودجه
Cancel	لغو
Cancer	سرطان
Carrot	هویج
Cattle	گاو
Common	مشترک
Compel	مجبور کردن
Corner	گوشه
Couple	زن و شوهر
Course	دوره
Create	ايجاد كردن
Custom	سفارشی
Damage	خسارت
Dancer	رقصنده
Danger	خطر
Decade	دهه
Defeat	شکست
Delete	حذف
Demand	تقاضا
Desire	میل
Detail	جزئیات
Dinner	شام
Divine	الهی
Donkey	الاغ
Double	دو برابر
Edible	خوراکی
Effect	اثر
Either	یا
Empire	امپراتوری

Read also:  Learn Time vocabulary in Persian
Energy	انرژی
Enough	کافی
Ensure	اطمینان حاصل شود
Entire	کل
Except	بجز
Expand	بسط دادن
Expect	انتظار
Export	صادرات
Extend	توسعه دادن، گسترش
Facade	نما
Family	خانواده
Famous	معروف
Faulty	معیوب
Favour	لطف
Famous	معروف
Favour	لطف
Female	زن
Fiance	نامزد
Finish	تمام کردن
Flower	گل
Forest	جنگل
Forgot	یادم رفت
Freeze	یخ زدگی
Friend	دوست
Future	آینده
Garage	گاراژ
Garden	باغ
Garlic	سیر
Ginger	زنجبیل
Global	جهانی است
Ground	زمین
Growth	رشد
Health	سلامتی
Hidden	پنهان شده است
Honest	صادقانه
Honour	افتخار و احترام
Hostel	خوابگاه
Humble	فروتن
Hungry	گرسنه
Ignore	چشم پوشی
Impact	تأثیر
Impure	نجس
Income	درآمد
Inform	آگاه کردن
Insect	حشره
Inside	داخل
Jungle	جنگل
Kidnap	آدم ربایی
Kindle	روشن شدن
Labour	کار یدی
Leader	رهبر
Length	طول
Letter	حرف
Liquid	مایع
Little	مقدار کمی

Read also:  Learn Real estate vocabulary in Persian
Living	زندگي كردن
Lizard	مارمولک
Locate	پیدا کردن
Luxury	لوکس
Making	ساخت
Mammal	پستاندار
Manage	مدیریت کنید
Manual	کتابچه راهنمای
Market	بازار
Mental	ذهنی
Method	روش
Middle	وسط
Monkey	میمون
Mother	مادر
Muscle	ماهیچه
Narrow	محدود، تنگ
Native	بومی
Nature	طبیعت
Normal	طبیعی
Number	عدد
Object	هدف – شی
Office	دفتر
Option	گزینه
Parent	والدین
Parrot	طوطی
People	مردم
Person	شخص
Pickle	ترشی
Picnic	پیک نیک
Pigeon	کبوتر
Planet	سیاره
Please	لطفا
Plenty	فراوانی
Police	پلیس
Potato	سیب زمینی
Praise	ستایش
Prayer	دعا
Pretty	بسیار
Prince	شاهزاده
Profit	سود
Proper	مناسب
Public	عمومی
Rabbit	خرگوش
Recent	اخیر
Recipe	دستور آشپزی
Record	رکورد
Reduce	كاهش دادن
Regret	پشیمان شدن. پشیمانی
Reject	رد کردن
Remind	به یاد آوردن
Remove	برداشتن
Repair	تعمیر
Repeat	تکرار
Return	برگشت
Rotate	چرخاندن

Read also:  50 Body parts names with pictures in English
Safety	ایمنی
Salary	حقوق
Sample	نمونه
School	مدرسه
Screen	صفحه نمایش
Script	اسکریپت
Scroll	طومار
Search	جستجو کردن
Season	فصل
Secret	راز
Secure	امن است
Select	انتخاب کنید
Senior	ارشد
Shield	سپر
Should	باید
Shower	دوش
Silent	بی صدا
Single	تنها
Sister	خواهر
Smooth	صاف
Social	اجتماعی
Speech	سخن، گفتار
Street	خیابان
Strong	قوی
Sudden	ناگهانی
Summer	تابستان
Supply	عرضه
Talent	استعداد
Temple	معبد
Thread	نخ
Thrill	هیجان
Throat	گلو
Tittle	عنوان
Toilet	توالت
Tomato	گوجه فرنگی
Tongue	زبان
Travel	مسافرت رفتن
Tunnel	تونل
Turtle	لاک پشت
Unseen	دیده نشده
Update	به روز رسانی
Urgent	فوری
Useful	مفید
Vacate	خالی کردن
Vacuum	خلاء
Vapour	بخار
Verify	تایید کنید
Virgin	باکره
Wealth	ثروت
Weekly	هفتگی
Weight	وزن
Winter	زمستان
Winner	برنده
Wonder	تعجب
Worker	کارگر
Writer	نویسنده
Yearly	سالانه
7 letter words
Achieve	رسیدن
Advance	پیشرفت
Against	در برابر
Already	قبلا، پیش از این
Ancient	کهن
Anybody	هر شخصی
Approve	تایید
Apology	عذرخواهی
Archive	بایگانی
Arrange	ترتیب دادن
Arrival	ورود
Article	مقاله
Attempt	تلاش
Attract	جذب کنند
Average	میانگین
Bandage	بانداژ
Barrage	رگبار
Barrier	مانع
Because	زیرا
Benefit	سود
Between	بین
Cabbage	کلم
Capture	گرفتن
Careful	مراقب باشید
Carrier	حامل
Century	قرن
Certain	مسلم – قطعی
Chamber	محفظه – اتاق
Chapter	فصل
Charity	خیریه
Climate	اقلیم
Coconut	نارگیل
Collect	جمع آوری کنید
College	دانشکده
Comfort	راحتی
Command	فرمان
Comment	اظهار نظر
Company	شرکت
Compare	مقایسه کنید
Concept	مفهوم
Concern	نگرانی
Conduct	هدایت
Confirm	تایید
Connect	اتصال
Contact	مخاطب
Control	کنترل
Convert	تبدیل
Correct	درست
Costume	لباس
Cottage	کلبه
Country	کشور
Courage	شجاعت
Cucumber	خیار
Curious	کنجکاو
Declare	اعلام
Defense	دفاع
Dentist	دندانپزشک
Deposit	سپرده

Read also:  Learn Places vocabulary in Persian
Despite	با وجود
Destiny	سرنوشت
Destroy	از بین رفتن
Develop	توسعه دهد
Disease	بیماری
Display	نمایش دادن
Disturb	مزاحم
Dynasty	سلسله
Eagerly	مشتاقانه
Earning	درآمد
Eatable	قابل خوردن
Ecology	بوم شناسی
Economy	اقتصاد
Edition	نسخه
Elegant	ظریف
Enhance	افزایش دهد
Episode	قسمت
Example	مثال
Evening	عصر
Exclude	حذف کردن
Explain	توضیح
Explore	کاوش
Educate	آموزش
Factory	کارخانه
Failure	شکست
Feature	ویژگی
Finance	دارایی، مالیه، سرمایه گذاری
Flavour	طعم و مزه
Fluency	روانی
Forever	برای همیشه
Further	به علاوه
Garment	لباس
General	عمومی
Genuine	اصل
Glamour	زرق و برق
Grammar	دستور زبان
Grocery	خواربار
Habitat	زیستگاه
Harmful	زیان آور
Harvest	محصول
Heading	عنوان
Hearing	شنیدن
Helpful	مفید
History	تاریخ
Holding	برگزاری
Holiday	تعطیلات
Hundred	صد
Husband	شوهر
Hygiene	بهداشت
Impress	تاثیر گذاشتن
Improve	بهتر کردن
Include	عبارتند از
Initial	اولیه
Inspect	بازرسی
Inspire	الهام بخشیدن
Journey	سفر
Justice	عدالت
Leading	منتهی شدن
Leather	چرم
Leaving	ترک
Lecture	سخنرانی

Read also:  Challenging vocabulary words
Liberal	لیبرال
Lovable	دوست داشتنی
Luggage	بار مسافر
Manager	مدیر
Maximum	بیشترین
Meaning	معنی
Measure	اندازه گرفتن
Medical	پزشکی
Message	پیام
Migrant	مهاجر
Mineral	معدنی
Minimum	کمترین
Miracle	معجزه
Missile	موشک
Missing	گم شده
Mistake	اشتباه
Morning	صبح
Mustard	خردل
Mystery	رمز و راز
Narrate	روایت کند
Natural	طبیعی
Naughty	شیطون
Neglect	بی توجهی
Neither	هیچ کدام
Nervous	عصبی
Network	شبکه
Nothing	هیچ چی
Observe	رعایت کنید
Opening	افتتاح
Operate	عمل کنند
Opinion	نظر
Organic	ارگانیک. آلی
Ostrich	شترمرغ
Package	بسته بندی
Painful	دردناک
Partial	جزئي
Passage	گذر
Patient	صبور
Payment	پرداخت
Penalty	پنالتی
Pending	انتظار
Penguin	پنگوئن
Pension	حقوق بازنشستگی
Perfect	کامل
Perfume	عطر
Popular	محبوب
Pottery	سفالگری
Poverty	فقر
Prevent	جلوگیری کردن
Privacy	حریم خصوصی
Private	خصوصی
Problem	مسئله
Produce	تولید کردن
Propose	پیشنهاد کند
Purpose	هدف
Quality	کیفیت
Quickly	به سرعت
Receive	دريافت كردن

Read also:  Learn Food vocabulary in Persian
Regular	منظم
Related	مربوط
Release	رهایی
Replace	جایگزین کردن
Reptile	خزنده
Request	درخواست
Respect	توجه
Respond	پاسخ دادن
Revenge	انتقام گرفتن
Revenue	درآمد
Reverse	معکوس
Robbery	سرقت
Romance	داستان عاشقانه
Science	علوم پایه
Serious	جدی
Servant	خدمتگزار
Service	سرویس
Similar	مشابه
Society	جامعه
Sparrow	گنجشک
Special	خاص
Stomach	معده
Student	دانشجو
Success	موفقیت
Suggest	پیشنهاد می دهد
Suicide	خودکشی کردن
Support	حمایت کردن
Suspend	تعلیق کند
Teacher	معلم
Teenage	نوجوان
Tension	تنش
Tourism	گردشگری
Trouble	مشکل
Uniform	لباس فرم
Utility	سودمندی
Vacancy	جای خالی
Variety	تنوع
Vehicle	وسیله نقلیه
Village	دهکده
Vintage	قدیمی
Victory	پیروزی
Violent	خشن
Visible	قابل رویت
Visitor	بازدید کننده
Vitamin	ویتامین
Walking	پیاده روی
Wanting	خواستن
Warning	هشدار
Wealthy	ثروتمند
Weather	آب و هوا
Wedding	عروسی
Welcome	خوش آمدی
Welfare	رفاه
Winning	برنده شدن
Working	کار کردن
Worried	نگران
Worship	عبادت
Writing	نوشتن
8 letter words
Abnormal	غیرطبیعی
Absolute	مطلق
Accepted	پذیرفته شده
Accident	تصادف
Accuracy	دقت
Activate	فعال کردن
Addition	علاوه بر این
Adequate	کافی است
Affected	متأثر، تحت تأثیر، دچار، مبتلا
Alphabet	الفبا
Anything	هر چیزی
Anywhere	هر جا
Appraise	ارزیابی
Approach	رویکرد
Approval	تصویب
Argument	بحث و جدل
Assemble	جمع آوری کنید
Attitude	نگرش
Audience	حضار
Attorney	وکیل
Aviation	هواپیمایی
Backward	به عقب
Beginner	مبتدی
Birthday	روز تولد
Bleeding	خون ریزی
Building	ساختمان
Campaign	پویش
Carriage	کالسکه
Children	فرزندان
Cleavage	رخ
Complete	کامل
Conserve	کنسرو
Consider	در نظر گرفتن
Consumer	مصرف كننده
Continue	ادامه هید
Criminal	جنایی
Critical	بحرانی
Daughter	فرزند دختر
Decision	تصمیم گیری
Decrease	نزول کردن
Delicate	ظریف
Delivery	تحویل
Delusion	توهم
Describe	توصیف کردن
Disagree	مخالف بودن
Disallow	اجازه ندادن
Duration	مدت زمان

Read also:  Learn Greetings vocabulary in Persian
Economic	اقتصادی
Elephant	فیل
Eligible	واجد شرایط
Employee	کارمند
Enormous	عظیم
Entrance	ورود
Envelope	پاكت نامه
Estimate	تخمین زدن
Everyday	هر روز
Exercise	ورزش
Explicit	صریح
Exposure	قرار گرفتن در معرض بیماری
External	خارجی
Facility	امکانات
Faithful	با ایمان
Favorite	مورد علاقه
Favorite	مورد علاقه
Festival	جشنواره
Flexible	قابل انعطاف
Friction	اصطکاک
Generate	تولید می کنند
Greeting	احوالپرسی
Guardian	نگهبان
Heritage	میراث
Horrible	ناگوار
Hospital	بیمارستان
Humorous	طنز
Identity	هویت
Incident	حادثه
Increase	افزایش دادن
Indicate	نشان می دهد
Industry	صنعت
Jealousy	حسادت
Learning	یادگیری
Location	محل
Majority	اکثریت
Marriage	ازدواج
Material	مواد
Medicine	دارو
Moderate	در حد متوسط
Mosquito	پشه
Mountain	کوه
Narrator	راوی
Nutrient	ماده مغذی
Opposite	مقابل
Original	اصلی
Ornament	زینت
Painting	رنگ آمیزی
Particle	ذره
Patience	صبر
Pleasure	لذت
Position	موقعیت
Positive	مثبت

Read also:  Learn Animals names in Persian
Possible	ممکن است
Postpone	عقب انداختن
Powerful	قدرتمند
Precious	گرانبها
Pregnant	حامله
Pressure	فشار
Previous	قبلی
Progress	پیش رفتن
Prohibit	ممنوع کرده است
Property	ویژگی
Purchase	خرید
Quantity	تعداد
Recovery	بهبود
Regional	منطقه ای
Relevant	مربوط
Religion	دین
Remember	یاد آوردن
Research	پژوهش
Resource	منبع
Response	واکنش
Restrict	محدود کردن
Revision	تجدید نظر
Sensible	معقول
Sentence	جمله
Separate	جداگانه، مجزا
Stranger	غریبه
Strategy	استراتژی
Strength	استحکام – قدرت
Struggle	تقلا
Suitable	مناسب
Superior	برتر
Surprise	تعجب
Swelling	تورم
Terrible	وحشتناک
Together	با یکدیگر
Tomorrow	فردا
Training	آموزش
Transfer	انتقال
Transmit	انتقال. رساندن
Treasure	گنج
Umbrella	چتر
Universe	کائنات
Vacation	تعطیلات
Validate	تایید اعتبار
Vertical	عمودی
Vigorous	قوی
Violence	خشونت
Vocation	حرفه
Vomiting	استفراغ
Wildlife	حیات وحش
Yielding	تسلیم شدن
Yourself	خودت
Youthful	جوان
Hard words
9 letter words
Accession	الحاق
Accessory	لوازم جانبی
Accompany	همراهی کردن
Actualize	بالفعل کردن
Admirable	قابل تحسین
Advantage	مزیت – فایده – سود – منفعت
Advisable	قابل توصیه
Affection	محبت
Affiliate	وابسته
Afternoon	بعد از ظهر
Aggregate	تجمیع
Agreement	توافق
Allowance	کمک هزینه
Alternate	متناوب
Ambiguous	مبهم
Animation	انیمیشن
Apologist	معذرت خواهی
Applicant	درخواست کننده
Architect	معمار
Associate	وابسته
Astronomy	ستاره شناسی
Attention	توجه
Attribute	صفت
Authority	قدرت
Automatic	خودکار
Available	در دسترس
Awareness	اطلاع
Beautiful	زیبا
Behaviour	رفتار – اخلاق
Butterfly	پروانه
Calibrate	کالیبره کردن
Candidate	نامزد
Celebrate	جشن گرفتن
Challenge	چالش
Confident	مطمئن
Confusion	گیجی
Conscious	هوشیار، آگاه
Crocodile	تمساح
Curiosity	کنجکاوی
Dangerous	خطرناک
Delicious	خوشمزه – لذیذ
Democracy	دموکراسی
Dependent	وابسته
Different	ناهمسان
Difficult	دشوار
Discovery	کشف
Dishonest	متقلب
Diversity	تنوع
Duplicate	تکراری
Education	تحصیلات
Effective	تاثير گذار
Emergency	اضطراری
Equipment	تجهیزات
Essential	ضروری است
Establish	تاسيس كردن
Evolution	سیر تکاملی
Excellent	عالی
Expensive	گران

Read also:  Learn disease names in Persian
Fantastic	خارق العاده
Fertility	باروری
Financial	مالی
Generally	بطور کلی
Glamorous	فریبنده
Happening	اتفاق می افتد
Household	خانواده
Identical	همسان
Important	مهم
Incorrect	غلط
Incorrupt	فاسد
Influence	نفوذ
Insurance	بیمه
Interview	مصاحبه
Intestine	روده
Introduce	معرفی کنید
Invention	اختراع
Invisible	نامرئی
Irregular	بی رویه
Jewellery	جواهرات
Knowledge	دانش
Liability	مسئولیت
Misbehave	بد رفتار کردن
Narration	روایت
Necessity	ضرورت
Negotiate	مذاکره کنند
Nutrition	تغذیه
Offensive	توهین آمیز
Partition	تقسیم بندی
Political	سیاسی
Pollution	آلودگی
Potential	پتانسیل
Practical	کاربردی
Precision	دقت، درستی
Privilege	امتیاز
Procedure	روش
Prominent	برجسته
Professor	استاد
Promotion	ترویج
Provoking	تحریک کننده
Qualified	واجد شرایط
Reference	ارجاع
Repulsion	دافعه
Residence	محل سکونت
Sacrifice	قربانی
Sensitive	حساس
Something	چیزی
Statement	بیانیه
Subscribe	اشتراک در
Substance	ماده
Sugarcane	نیشکر
Sunflower	آفتابگردان
Surrender	تسلیم شدن
Technical	فنی
Temporary	موقت
Terrorist	تروریست
Treatment	رفتار
Variation	تغییر
Vegetable	سبزی
Virginity	باکرگی
Yesterday	دیروز
10 letter words
Abbreviate	مخفف کردن
Absolutely	کاملا
Absorption	جذب
Acceptable	قابل قبول
Achievable	قابل دستیابی
Additional	اضافی
Admiration	تحسین
Adolescent	نوجوان
Adulterant	خیانتکار
Adventurer	ماجراجو
Afterwards	پس از آن
Aggression	پرخاشگری
Alteration	تغییر
Ambassador	سفیر
Analytical	تحلیلی
Antibiotic	آنتی بیوتیک
Anticipate	پیش بینی کنید
Appreciate	قدردانی
Artificial	ساختگی
Aspiration	تنفس
Assignment	وظیفه
Atmosphere	جو
Attachment	پیوست
Attraction	جاذبه
Chloroform	کلروفرم
Combustion	احتراق
Commission	کمیسیون
Compassion	رحم و شفقت – دلسوزی
Compulsory	اجباری
Conclusion	نتیجه
Confection	شیرینی
Corruption	فساد
Decoration	تزیین
Dedication	فداکاری
Deficiency	کمبود
Definition	تعریف
Department	بخش
Depression	افسردگی
Dictionary	فرهنگ لغت
Discipline	انضباط
Disclaimer	سلب مسئولیت
Disclosure	افشای

Read also:  Learn month names in Persian
Discussion	بحث
Efficiency	بهره وری
Employment	استخدام
Engagement	نامزدی
Everything	همه چيز
Everywhere	هر کجا
Exhibition	نمایشگاه
Experience	تجربه
Experiment	آزمایش
Expiration	انقضاء
Expression	اصطلاح
Fertilizer	کود
Foundation	پایه
Generation	نسل
Government	دولت
Importance	اهمیت
Impossible	غیر ممکن
Inadequate	ناکافی
Incomplete	ناقص
Incredible	باور نکردنی
Individual	شخصی
Inspection	بازرسی
Instrument	ابزار
Irrigation	آبیاری
Journalism	روزنامه نگاری
Management	مدیریت
Moderation	اعتدال
Motivation	انگیزه
Negligible	قابل اغماض
Occupation	اشتغال
Particular	خاص
Passionate	پرشور
Permission	اجازه
Population	جمعیت
Production	تولید
Prostitute	فاحشه
Protection	حفاظت
Psychology	روانشناسی
Punishment	مجازات
Quarantine	قرنطینه
Retirement	بازنشستگی
Sufficient	کافی
Supervisor	سرپرست
Supplement	مکمل
University	دانشگاه
Vegetarian	گیاه خواری
Visibility	دید
Vulnerable	آسیب پذیر
Advanced words
11 letter words
Accommodate	تطبیق
Achievement	دستاورد
Acknowledge	اذعان
Affirmation	تایید
Aggregation	تجمع
Agriculture	کشاورزی
Alternation	تناوب
Anniversary	سالگرد
Application	کاربرد
Appointment	وقت ملاقات
Appreciable	قابل تقدیر
Approximate	تقریبی
Association	اتحادیه
Certificate	گواهی
Competition	رقابت
Cultivation	کشت
Corporation	شرکت
Cooperation	مشارکت
Dehydration	کم آبی بدن
Discontinue	متوقف کردن
Elimination	حذف
Environment	محیط
Evaporation	تبخیر
Examination	معاینه
Expenditure	مخارج
Fabrication	ساخت
Improvement	بهبود
Independent	مستقل
Information	اطلاعات
Inspiration	الهام گرفتن
Institution	موسسه، نهاد
Instruction	دستورالعمل
Intelligent	باهوش
Manufacture	ساخت
Measurement	اندازه گیری
Mensuration	قاعدگی
Observation	مشاهده
Opportunity	فرصت
Participant	شرکت کننده
Performance	کارایی
Preparation	آماده سازی
Significant	قابل توجه
Temperature	درجه حرارت
Translation	ترجمه
Transparent	شفاف
Vaccination	واکسیناسیون
12, 13 letter words
Abbreviation	مخفف
Administrate	اداره کنند
Appreciation	قدردانی
Accommodation	محل اقامت
Accompaniment	همراهی
Administrator	مدیر
Advertisement	تبلیغات
Administration	مدیریت
Acknowledgement	تصدیق
Conformation	ساختار
Conservation	حفاظت
Constitution	قانون اساسي
Construction	ساخت و ساز
Contribution	مشارکت
Communication	ارتباط
Classification	طبقه بندی
Congratulation	تبریک
Disadvantage	عیب
Entrepreneur	کارآفرین
Entertainment	سرگرمی
Extraordinary	خارق العاده
Horticulture	باغبانی
Intermediate	حد واسط
Introduction	معرفی
Investigation	تحقیق و بررسی
International	بین المللی
Identification	شناسایی
Justification	توجیه
Knowledgeable	آگاه
Maintainable	قابل نگهداری
Organization	سازمان
Presentation	ارائه
Preservation	حفظ
Purification	تطهیر
Participation	مشارکت
Registration	ثبت
Reproduction	تولید مثل
Satisfaction	رضایت
Self-confidence	اعتماد به نفس
Transformation	دگرگونی
Transportation	حمل و نقل

Fruits Quiz
Play

Animals Quiz
Play

Household Quiz
Play

Stationary Quiz
Play
Play more Picture vocabulary
Daily use Persian Sentences

English to Persian – here you learn top sentences, these sentences are very important in daily life conversations, and basic-level sentences are very helpful for beginners. All sentences have Persian meanings with transliteration.
Good morning	صبح بخیر
What is your name	اسم شما چیست
What is your problem?	مشکلت چیه؟
I hate you	ازت متنفرم
I love you	دوستت دارم
Can I help you?	میتونم کمکتون کنم؟
I am sorry	متاسفم
I want to sleep	من میخواهم بخوابم
This is very important	این بسیار مهم است
Are you hungry?	آیا شما گرسنه هستید؟
How is your life?	زندگی شما چطور است؟
I am going to study	می خواهم درس بخوانم